################
#..............#
#..###....###..#
#..#........#..#
#..#..####..#..#
#.....#..#.....#
#.....####.....#
#..............#
###............#
#........####..#
#..#.....#.....#
#..#.....#..####
#..#...........#
#..###.........#
#..............#
################
